NO ./path_to_the_north_texture
WE ./path_to_the_west_texture


EA    ./a
SO ./a


       C    222   , 30    ,    0 
F 220,100,0

1111111
10S0001
100011111111
10000011111
1111111111
111